mary	changeMe!
paulj	123456
jimmyN	neutron238
telsa	electric
machnum	v/a
skunkworks	kelly
george	ohmV/I
jdiehl	SomePassword
ragrawal	apwd
barmatis	apwd
mithbutler	apwd
cocarson	apwd
jchrisman	apwd
ncolosimo	apwd
teggebrecht	apwd
cgin	apwd
jggonzalez	apwd
mharmon1	apwd
khickm40	apwd
bhock	apwd
jahudson	apwd
sknowles	apwd
mlasker	apwd
samaier	apwd
agmartin	apwd
janguyen	apwd
jwowen	apwd
zren	apwd
lrobertiii	apwd
kaseward	apwd
esharrowducsay	apwd
esink	apwd
cjslider	apwd
jobaweber	apwd